####################   ###############################################
#@                                                                   #
#                                                                    #
#     ###                                                            #
#                                                                    #
#                                                                    #
#                   ~~                                               #
#                                                                    #
#                                                                    #
#                                                                    #
#                                                                    #
#                                                                    #
#                                                                    #
#                                                                    #
######################################################################
