####### ##############################################################
#@   #   #   #    #G    #            ~~#           #                 #
#  G # M | #    # ####  #  ######### ~~## ##~ ~~~~Z# #####^ ~~~~~ ~ G#
#   &############          #         ###   ##G###### #   Z^ ~     ~~~#
#  *~##   G     ############  #    ~##     %           ^^^^ ~ ~~~   ~#
#  ~~##     ~#            ##  # G####  %  %^^^^^^^^^^^^^    ~ ~  ~~ ~#
#    #####   ###########   ## ####    %%%%%^        #    ~~   ~ ~ ~ ~#
#  ?    ~#~   #       ##   #      B~~%%   %^^% ###  #~~ Z~~~~~~ ~ ~ ~#
#   ~~  G#        ~    #   #~####~~~~% %%  %^   ~#  #~~~~~~~~ ~G~ ~ ~#
#  ~~###########~~~    #         ~~~~%  %  B^  ~~~  ##               #
# ~~~#          ~~~~~~ #~~ ###   ~~~~% %%%%^^   ~~   #  ##############
#  ~~#   ####   ~~~~~~ #   #   ~~~~~%% % G%^H ~  ~~~ ~~              #
#   ~#   #Z ~   ~~~    # ~~#   ~~~%%%% % %^^#### ~Z# ~~~########### ##
#        #    ~     ~~~#  Z#                       #         G       #
######################################################################

/I/E|G 		|ghost  	|0
/I/E|Z 		|zombie  	|1
/I/E|B 		|basilisk  	|0
/I/E|H 		|hydra  	|1
/I/E|M 		|EvilMaster  	|2
/I/O|#		|wall			|No known threat	
/I/O|~		|lava			|Swimming into hot lava will eventually lead to death
/I/O|%		|spellbound forest	|Noone has ever escaped the spellbound forest
/I/O|^		|river of mercury	|These shimmering waters hold greatest of threats
/I/P|?|fountain of youth|0|15
/I/P|&|lost bag|3|100
/I/P|*|book|2|35
